########
# ##   #
#    # #
#P ##@ #
########